{
    "name": "cave",
    "author": "losdayver",
    "static": [
        "=============================================================",
        "===========....===============.............==================",
        "=======............========......................============",
        "========.x.x.......========........................==========",
        "===========xx......========............========.....=========",
        "=============......=========........=============....========",
        "=============.......=========......==============....========",
        "===========..........====........=============.......========",
        "=========...........................................=========",
        "=========....x......................................=========",
        "=========##.xx.........................................======",
        "===========####.xx...###################................=====",
        "===...======================================...........======",
        "======...=====================...===========...........======",
        "=============================.......=========.........=======",
        "===============....==============...========...........======",
        "===========...........====================.........$%%%%%====",
        "========..............................................=======",
        "=========..............................................======",
        "=========...........................................=========",
        "==========..xx.......=============.............==============",
        "==============xx...x===============..........================",
        "================================.............================",
        "========......===================............================",
        "=======..x......==================.x......x....==============",
        "========xx.x...======================..x.xx==================",
        "============================================================="
    ],
    "dynamic": [
    ],
    "scenic": {

    },
    "background": "starfield",
    "spawns": [
        [24, 6],
        [14, 19],
        [50, 19],
        [58, 7]
    ]
}