{
    "name": "cave",
    "author": "losdayver",
    "static": [
        "=============================================================",
        "=======####....####=======####.............######============",
        "======#............#======#......................#===========",
        "=======#.x.x.......#======#........................#=========",
        "========###xx......#======#............########.....#========",
        "=============......#=======#........###========##....#=======",
        "=============.......#====####......#==========###....#=======",
        "===========..........####........#############.......#=======",
        "=========...........................................#========",
        "=========....x......................................#========",
        "=========##.xx.........................................#=====",
        "===========####.xx...###################................#====",
        "===...=========######===================####...........#=====",
        "======...=====================...==========#...........#=====",
        "=============================.......========#.........#======",
        "===========####....####==========...======##...........#=====",
        "========###...........####################.........$%%%%%====",
        "=======#..............................................#======",
        "========#..............................................#=====",
        "========#...........................................###======",
        "=========#..xx.......#############.............#####=========",
        "==============xx...x#=============#..........##==============",
        "================###=============.............#===============",
        "========......==================#............#===============",
        "=======..x......=================#.x......x.....#============",
        "========xx.x...===================###..x.xx####==============",
        "============================================================="
    ],
    "dynamic": [
    ],
    "scenic": {

    },
    "background": "forest",
    "spawns": [
        [12, 2],
        [36, 7],
        [15, 18],
        [49, 18]
    ]
}
