{
    "name": "facility",
    "author": "losdayver",
    "static": [
        "EEEEEEEEEEEEEEEEEEEEEEEEEEEEEEEEEEEEEEEEEEEEEEEEEEEEEEEEEEEEE",
        "E...........................................................E",
        "E...........................................................E",
        "E...........................................................E",
        "E.........................$.................................E",
        "E................x........$%%%%$............................E",
        "E.............x..xx.......$.................................E",
        "E......xx..xx.xxxxxx.x....$.............................x...E",
        "E...$%%%%%%%%%%%%%%%%%%%%%$.............................x...E",
        "E....................................................*******E",
        "E......................................$%$.............=====E",
        "E.........................................................==E",
        "E.x.........................................................E",
        "Exxxx...xx..................................................E",
        "E%%%$..$%%%%$..................................$%$..........E",
        "E......................................x....................E",
        "E.....................................xxx.x.................E",
        "E.....##.........$%%%%%$.........$%%%%%%%%%%$.............$%E",
        "E...######..................................................E",
        "E..########.................................................E",
        "E..+......+................x................................E",
        "E..+x....................====..................x.......x....E",
        "E..+xx................========...............xxx......xx....E",
        "*..***...****************************.....*******************",
        "&..&&&&...&&&&&=&&&&&&&&&=&&&&&&&&&&&*...*=&&&&&&&&&&&&&&&&&&",
        "=.......................................*=====&&&&&&==&&&&&&&",
        "=.......................................=====================",
        "=========&&&&&==============&&&&=============================",
        "============================================================="
    ],
    "dynamic": [
    ],
    "scenic": {

    },
    "background": "abstract",
    "spawns": [
        [24, 6],
        [14, 19],
        [50, 19],
        [58, 7]
    ]
}