{
    "name": "battleground",
    "author": "losdayver",
    "static": [
        "E...........................................................E",
        "E...........................................................E",
        "E...........................................................E",
        "E...........................................................E",
        "E...........................................................E",
        "E...........................................................E",
        "E...........................................................E",
        "E...........................................................E",
        "E...........................................................E",
        "E...........................................................E",
        "E...........................................................E",
        "E...........................................................E",
        "E.x.........................................................E",
        "Exxxx...xx..................................................E",
        "E%%%%%%%%%%%$...............................................E",
        "E......................................x....................E",
        "E.....................................xxx.x.................E",
        "E.....##.........$%%%%%%%%%%$....$%%%%%%%%%%$..............%E",
        "E...######................................................%.E",
        "E..########..........................................%%%%%..E",
        "E..+......+.................................................E",
        "E..+x....................====..................x........====E",
        "E..+xx................========...............xxx.....=======E",
        "*************************************.....*******************",
        "&&&&&&&&&&&&&&&=&&&&&&&&&=&&&&&&&&&&&*...*=&&&&&&&&&&&&&&&&&&",
        "==&&&&===&&&&====&&&&&&====&&&&&&&&===***=====&&&&&&==&&&&&&&",
        "=============================================================",
        "=============================================================",
        "============================================================="
    ],
    "dynamic": [
    ],
    "scenic": {

    },
    "background": "abstract",
    "spawns": [
        [6, 3],
        [10, 3],
        [15, 3],
        [18, 3]
    ]
}