{
    "name": "parkour",
    "author": "n1st",
    "static": [
        "EEEEEEEEEEEEEEEEEEEEEEEEEEEEEEEEEEEEEEEEEEEEEEEEEEEEEEEEEEEEE",
        "E...........................................................E",
        "E...........................................................E",
        "E...........................................................E",
        "E...........................................................E",
        "E...........................................................E",
        "E.............................%%%%%.........................E",
        "E......................................x....................E",
        "E......................===.............x....................E",
        "E.........................=............x.......#############E",
        "E..........................=...........x....................E",
        "E...........................=...............................E",
        "E............................=..............................E",
        "E.............................=.............................E",
        "E...........$$$$$$.............=======......................E",
        "E...........................................................E",
        "E...........................................................E",
        "E...........................................................E",
        "E####..........................=............................E",
        "E..............................=............................E",
        "E..............................=............................E",
        "E............====..............=.................===........E",
        "E................=..........................................E",
        "E.................=.........................................E",
        "E..................=........................................E",
        "E...................========............=====...............E",
        "E...........................................................E",
        "E...........................................................E",
        "============================================================="
    ],
    "dynamic": [
    ],
    "scenic": {

    },
    "background": "starfield",
    "spawns": [
        [24, 6],
        [14, 19],
        [50, 19],
        [58, 7]
    ]
}