{
    "name": "facility",
    "author": "losdayver",
    "static": {
        "scene": [
            "..........................................................",
            "..........................................................",
            "..........................................................",
            "..........................................................",
            "..........................................................",
            "..........................................................",
            "..........................................................",
            "..........................................................",
            "..........................................................",
            "..........................................................",
            "..........................................................",
            "..........................................................",
            ".............................#####################........",
            "..#.......................................................",
            "..#.......................................................",
            "..#.......................................................",
            "###################.......................................",
            "..........................................................",
            "..........................................................",
            "##########################################################"
        ]
    },
    "dynamic": {
    },
    "scenic": {

    }
}