{
    "name": "facility",
    "author": "losdayver",
    "static": [
        "..........................................................",
        "..........................................................",
        "..........................................................",
        "..........................................................",
        "..........................................................",
        "..........................................................",
        "..........................................................",
        "...####...................................................",
        "..........................................................",
        "...............####.......................................",
        "..........................................................",
        "..........................................................",
        "#######.......######......................................",
        "..........................................................",
        "..........................................................",
        "..........................................................",
        "##########################################################"
    ],
    "dynamic": [
        {
            "type": "box",
            "id": 1,
            "position": [5, 5],
            "vector": [0, 0]
        },
        {
            "type": "box",
            "id": 2,
            "position": [6, 10],
            "vector": [0, 0]
        }
    ],
    "scenic": {

    },
    "background": "starfield"
}