{
    "name": "facility",
    "author": "losdayver",
    "static": [
        "$...................$.......$",
        "$...................$.......$",
        "$...................$.......$",
        "$...................$.......$",
        "$...................$.......$",
        "$...................$.......$",
        "$%%%%%....%%%%%%%%%%$.......$",
        "$...........................$",
        "$...........................$",
        "$..........................&$",
        "$.........................&&$",
        "$...........%%%%%%%%%%%%%%%%$",
        "$...........................$",
        "$...........................$",
        "$....=................==**..$",
        "$..=###**.......###=#####**.$",
        "&&&&&&&&&&&&&&&&&&&&&&&&&&&&&"
    ],
    "dynamic": [
    ],
    "scenic": {

    },
    "background": "abstract"
}